................#.?.
....$...........#.$.
................##.#
.#.....#.#..........
..#....#.#..........
#..#...#.#######....
.#..#..#..$.?..#....
..#..#.#########....
...#..##.#..$..#....
...............#....
..............##..##
......#...#...#.....
......#...#...#....$
#######...#...#.$.#.
?....$....#.$.#...#?